
SO ./south

R    20    20
NO  ./north

C 0,0,56
WE ./west
F 255,255,255

EA ./east
S ./sprite

11111111111
10010001001
11N11001001
11000011011
10020011111
10111000001
10100000001
10111010001
11000010101
11111111111
